symbol	tumorsuppressor	oncogene
A1CF	FALSE	TRUE
ABCB11	FALSE	FALSE
ABI1	TRUE	FALSE
ABL1	FALSE	TRUE
ABL2	FALSE	TRUE
ABRAXAS1	FALSE	FALSE
ACD	FALSE	FALSE
ACKR3	FALSE	TRUE
ACSL3	FALSE	FALSE
ACSL6	FALSE	FALSE
ACTB	FALSE	FALSE
ACTG1	FALSE	FALSE
ACVR1	FALSE	TRUE
ACVR1B	TRUE	FALSE
ACVR2A	TRUE	FALSE
ADGRA2	FALSE	FALSE
AFDN	FALSE	TRUE
AFF1	FALSE	FALSE
AFF3	FALSE	TRUE
AFF4	FALSE	TRUE
AGO2	FALSE	FALSE
AIP	FALSE	FALSE
AJUBA	FALSE	FALSE
AKAP9	FALSE	FALSE
AKT1	FALSE	TRUE
AKT2	FALSE	TRUE
AKT3	FALSE	TRUE
ALDH2	FALSE	FALSE
ALK	FALSE	TRUE
ALOX12B	FALSE	FALSE
AMER1	TRUE	FALSE
ANK1	FALSE	FALSE
ANKRD11	FALSE	FALSE
APC	TRUE	TRUE
APOB	FALSE	FALSE
APOBEC3B	FALSE	FALSE
AR	TRUE	TRUE
ARAF	FALSE	TRUE
ARFRP1	FALSE	FALSE
ARHGAP26	TRUE	FALSE
ARHGAP35	FALSE	FALSE
ARHGAP5	FALSE	TRUE
ARHGEF10	TRUE	FALSE
ARHGEF10L	TRUE	FALSE
ARHGEF12	TRUE	FALSE
ARHGEF28	FALSE	FALSE
ARID1A	TRUE	FALSE
ARID1B	TRUE	FALSE
ARID2	TRUE	FALSE
ARID3A	FALSE	FALSE
ARID3B	FALSE	FALSE
ARID3C	FALSE	FALSE
ARID4A	FALSE	FALSE
ARID4B	FALSE	FALSE
ARID5A	FALSE	FALSE
ARID5B	FALSE	FALSE
ARNT	FALSE	FALSE
ARTN	FALSE	TRUE
ASPSCR1	FALSE	FALSE
ASXL1	TRUE	FALSE
ASXL2	TRUE	FALSE
ATF1	FALSE	TRUE
ATF2	TRUE	TRUE
ATF3	TRUE	TRUE
ATF7IP	FALSE	FALSE
ATIC	FALSE	FALSE
ATM	TRUE	FALSE
ATP1A1	FALSE	FALSE
ATP2B3	TRUE	FALSE
ATP6AP1	FALSE	FALSE
ATP6V1B2	FALSE	FALSE
ATR	TRUE	FALSE
ATRX	TRUE	FALSE
ATXN2	FALSE	FALSE
AURKA	FALSE	TRUE
AURKB	FALSE	FALSE
AXIN1	TRUE	FALSE
AXIN2	TRUE	FALSE
AXL	FALSE	FALSE
B2M	TRUE	FALSE
BABAM1	FALSE	FALSE
BACH2	FALSE	FALSE
BAP1	TRUE	FALSE
BARD1	TRUE	FALSE
BAX	TRUE	FALSE
BAZ1A	TRUE	FALSE
BBC3	FALSE	FALSE
BCL10	TRUE	FALSE
BCL11A	FALSE	TRUE
BCL11B	FALSE	FALSE
BCL2	FALSE	TRUE
BCL2L1	FALSE	FALSE
BCL2L11	FALSE	FALSE
BCL2L12	FALSE	TRUE
BCL2L2	FALSE	FALSE
BCL3	FALSE	TRUE
BCL6	FALSE	TRUE
BCL6B	TRUE	FALSE
BCL7A	FALSE	FALSE
BCL9	FALSE	TRUE
BCL9L	FALSE	FALSE
BCLAF1	FALSE	FALSE
BCOR	TRUE	FALSE
BCORL1	FALSE	FALSE
BCR	FALSE	TRUE
BECN1	TRUE	FALSE
BIRC3	FALSE	FALSE
BIRC6	FALSE	TRUE
BLM	TRUE	FALSE
BMI1	FALSE	TRUE
BMP5	FALSE	FALSE
BMPR1A	FALSE	FALSE
BRAF	FALSE	TRUE
BRCA1	TRUE	FALSE
BRCA2	TRUE	FALSE
BRD3	FALSE	TRUE
BRD4	FALSE	TRUE
BRINP1	TRUE	FALSE
BRIP1	TRUE	FALSE
BTG1	TRUE	FALSE
BTG2	FALSE	FALSE
BTK	FALSE	FALSE
BUB1B	TRUE	FALSE
C15orf65	FALSE	FALSE
C2orf40	TRUE	FALSE
C2orf44	FALSE	FALSE
CACNA1D	FALSE	TRUE
CAD	FALSE	FALSE
CADM1	TRUE	FALSE
CALR	FALSE	TRUE
CAMTA1	TRUE	FALSE
CANT1	FALSE	FALSE
CARD11	FALSE	TRUE
CARM1	FALSE	FALSE
CARS	TRUE	FALSE
CASC5	FALSE	FALSE
CASP3	TRUE	FALSE
CASP8	TRUE	FALSE
CASP9	TRUE	FALSE
CASR	FALSE	FALSE
CBFA2T3	TRUE	FALSE
CBFB	TRUE	FALSE
CBL	FALSE	TRUE
CBLB	TRUE	FALSE
CBLC	FALSE	FALSE
CCDC6	TRUE	FALSE
CCNB1IP1	TRUE	FALSE
CCNC	TRUE	FALSE
CCND1	TRUE	TRUE
CCND2	FALSE	TRUE
CCND3	FALSE	TRUE
CCNE1	FALSE	TRUE
CCR4	FALSE	TRUE
CCR7	FALSE	TRUE
CD19	FALSE	FALSE
CD209	FALSE	FALSE
CD22	FALSE	FALSE
CD274	TRUE	TRUE
CD276	FALSE	FALSE
CD28	FALSE	TRUE
CD58	FALSE	FALSE
CD70	FALSE	FALSE
CD74	FALSE	TRUE
CD79A	FALSE	TRUE
CD79B	FALSE	TRUE
CDC42	FALSE	FALSE
CDC73	TRUE	TRUE
CDH1	TRUE	TRUE
CDH10	TRUE	FALSE
CDH11	TRUE	FALSE
CDH17	FALSE	TRUE
CDK12	TRUE	FALSE
CDK16	FALSE	TRUE
CDK4	FALSE	TRUE
CDK6	FALSE	TRUE
CDK8	FALSE	TRUE
CDKN1A	TRUE	TRUE
CDKN1B	TRUE	TRUE
CDKN1C	FALSE	FALSE
CDKN2A	TRUE	TRUE
CDKN2B	TRUE	TRUE
CDKN2C	TRUE	FALSE
CDX2	TRUE	TRUE
CEBPA	TRUE	FALSE
CENPA	FALSE	FALSE
CEP57	FALSE	FALSE
CEP89	FALSE	FALSE
CHCHD7	FALSE	FALSE
CHD2	TRUE	FALSE
CHD4	FALSE	TRUE
CHD5	TRUE	FALSE
CHEK1	FALSE	FALSE
CHEK2	TRUE	FALSE
CHIC2	FALSE	FALSE
CHST11	FALSE	TRUE
CIC	FALSE	FALSE
CIITA	TRUE	FALSE
CKS1B	FALSE	FALSE
CLIP1	FALSE	FALSE
CLP1	FALSE	FALSE
CLTC	TRUE	FALSE
CLTCL1	TRUE	FALSE
CNBD1	FALSE	FALSE
CNBP	TRUE	FALSE
CNOT3	TRUE	FALSE
CNTNAP2	TRUE	FALSE
CNTRL	FALSE	FALSE
COL1A1	FALSE	FALSE
COL2A1	FALSE	FALSE
COL3A1	FALSE	FALSE
COL7A1	FALSE	FALSE
COX6C	FALSE	FALSE
CPEB3	TRUE	FALSE
CRBN	FALSE	FALSE
CREB1	FALSE	TRUE
CREB3L1	TRUE	FALSE
CREB3L2	FALSE	TRUE
CREBBP	FALSE	FALSE
CRKL	FALSE	TRUE
CRLF2	FALSE	TRUE
CRNDE	FALSE	TRUE
CRNKL1	FALSE	FALSE
CRTC1	FALSE	TRUE
CRTC3	FALSE	FALSE
CSDE1	FALSE	FALSE
CSF1R	FALSE	TRUE
CSF3R	FALSE	TRUE
CSMD3	TRUE	FALSE
CTCF	TRUE	TRUE
CTLA4	FALSE	FALSE
CTNNA1	FALSE	FALSE
CTNNA2	FALSE	TRUE
CTNNB1	FALSE	TRUE
CTNND1	FALSE	FALSE
CTNND2	FALSE	TRUE
CTR9	FALSE	FALSE
CTRC	FALSE	FALSE
CUL3	TRUE	FALSE
CUX1	FALSE	FALSE
CXCR4	FALSE	TRUE
CYLD	TRUE	FALSE
CYP2C8	FALSE	FALSE
CYP2D6	FALSE	FALSE
CYR61	TRUE	FALSE
CYSLTR2	FALSE	TRUE
DAB2	TRUE	FALSE
DAPK1	TRUE	TRUE
DAXX	FALSE	FALSE
DCAF12L2	FALSE	FALSE
DCC	TRUE	FALSE
DCTN1	FALSE	FALSE
DCUN1D1	FALSE	FALSE
DDB2	FALSE	FALSE
DDIT3	FALSE	TRUE
DDR2	FALSE	TRUE
DDX10	TRUE	FALSE
DDX3X	TRUE	TRUE
DDX5	FALSE	TRUE
DDX6	FALSE	TRUE
DEK	FALSE	TRUE
DGCR8	FALSE	TRUE
DICER1	TRUE	FALSE
DIRAS3	TRUE	FALSE
DIS3	FALSE	FALSE
DIS3L2	FALSE	FALSE
DKC1	FALSE	FALSE
DLC1	TRUE	FALSE
DNAJB1	FALSE	FALSE
DNM2	TRUE	FALSE
DNMT1	FALSE	TRUE
DNMT3A	TRUE	FALSE
DNMT3B	FALSE	FALSE
DOCK8	FALSE	FALSE
DOT1L	FALSE	FALSE
DPYD	FALSE	FALSE
DROSHA	TRUE	FALSE
DTX1	FALSE	FALSE
DTX3L	FALSE	FALSE
DUSP22	FALSE	FALSE
DUSP4	FALSE	FALSE
DUX4L1	FALSE	FALSE
E2F3	FALSE	FALSE
EBF1	TRUE	FALSE
ECT2L	FALSE	FALSE
EED	TRUE	FALSE
EGF	FALSE	TRUE
EGFL7	FALSE	FALSE
EGFR	FALSE	TRUE
EGR1	TRUE	TRUE
EIF1AX	FALSE	FALSE
EIF3E	TRUE	FALSE
EIF4A2	FALSE	FALSE
EIF4E	FALSE	FALSE
ELANE	FALSE	FALSE
ELF3	TRUE	FALSE
ELF4	FALSE	FALSE
ELK4	FALSE	TRUE
ELL	TRUE	FALSE
ELN	FALSE	FALSE
ELOC	FALSE	FALSE
EML4	FALSE	FALSE
EMP3	TRUE	FALSE
EMSY	FALSE	FALSE
ENG	FALSE	FALSE
EP300	TRUE	FALSE
EP400	FALSE	FALSE
EPAS1	FALSE	FALSE
EPCAM	FALSE	FALSE
EPHA2	FALSE	TRUE
EPHA3	FALSE	FALSE
EPHA5	FALSE	FALSE
EPHA7	FALSE	FALSE
EPHB1	FALSE	FALSE
EPHB2	TRUE	FALSE
EPOR	FALSE	FALSE
EPS15	TRUE	FALSE
ERBB2	TRUE	TRUE
ERBB3	FALSE	TRUE
ERBB4	TRUE	TRUE
ERC1	FALSE	FALSE
ERCC1	FALSE	FALSE
ERCC2	TRUE	FALSE
ERCC3	TRUE	FALSE
ERCC4	TRUE	FALSE
ERCC5	TRUE	FALSE
ERF	FALSE	FALSE
ERG	FALSE	TRUE
ERRFI1	FALSE	FALSE
ESCO2	FALSE	FALSE
ESR1	TRUE	FALSE
ETNK1	TRUE	FALSE
ETS1	FALSE	TRUE
ETV1	FALSE	TRUE
ETV4	FALSE	TRUE
ETV5	FALSE	TRUE
ETV6	TRUE	TRUE
EWSR1	FALSE	TRUE
EXT1	TRUE	FALSE
EXT2	TRUE	FALSE
EZH1	FALSE	FALSE
EZH2	FALSE	TRUE
EZR	FALSE	FALSE
FAH	FALSE	FALSE
FAM131B	FALSE	FALSE
FAM135B	FALSE	FALSE
FAM175A	FALSE	FALSE
FAM46C	TRUE	FALSE
FAM47C	FALSE	FALSE
FAM58A	FALSE	FALSE
FANCA	TRUE	FALSE
FANCB	FALSE	FALSE
FANCC	TRUE	FALSE
FANCD2	TRUE	FALSE
FANCE	TRUE	FALSE
FANCF	TRUE	FALSE
FANCG	TRUE	FALSE
FANCI	FALSE	FALSE
FANCL	FALSE	FALSE
FANCM	FALSE	FALSE
FAS	TRUE	FALSE
FASN	FALSE	TRUE
FAT1	TRUE	FALSE
FAT3	FALSE	FALSE
FAT4	TRUE	FALSE
FBLN2	TRUE	FALSE
FBXO11	TRUE	FALSE
FBXW7	TRUE	FALSE
FCGR2B	FALSE	TRUE
FCRL4	FALSE	TRUE
FEN1	TRUE	FALSE
FES	FALSE	FALSE
FEV	FALSE	TRUE
FGF1	FALSE	FALSE
FGF10	FALSE	FALSE
FGF14	FALSE	FALSE
FGF19	FALSE	TRUE
FGF2	FALSE	FALSE
FGF23	FALSE	FALSE
FGF3	FALSE	FALSE
FGF4	FALSE	FALSE
FGF5	FALSE	FALSE
FGF6	FALSE	FALSE
FGF7	FALSE	FALSE
FGF8	FALSE	FALSE
FGF9	FALSE	FALSE
FGFR1	FALSE	TRUE
FGFR1OP	FALSE	FALSE
FGFR2	FALSE	TRUE
FGFR3	FALSE	TRUE
FGFR4	FALSE	TRUE
FH	TRUE	FALSE
FHIT	TRUE	TRUE
FIP1L1	FALSE	FALSE
FKBP9	FALSE	FALSE
FLCN	TRUE	FALSE
FLG	FALSE	FALSE
FLI1	FALSE	TRUE
FLNA	FALSE	FALSE
FLT1	FALSE	FALSE
FLT3	FALSE	TRUE
FLT4	FALSE	TRUE
FNBP1	FALSE	FALSE
FOS	FALSE	TRUE
FOXA1	FALSE	TRUE
FOXA2	FALSE	FALSE
FOXL2	FALSE	FALSE
FOXM1	FALSE	TRUE
FOXO1	TRUE	TRUE
FOXO3	TRUE	FALSE
FOXO4	FALSE	FALSE
FOXP1	TRUE	TRUE
FOXP3	TRUE	TRUE
FOXQ1	FALSE	FALSE
FOXR1	FALSE	TRUE
FRS2	FALSE	FALSE
FSTL3	FALSE	TRUE
FTO	FALSE	TRUE
FUBP1	FALSE	TRUE
FURIN	FALSE	FALSE
FUS	TRUE	TRUE
FYN	FALSE	FALSE
GAB2	FALSE	TRUE
GABRA6	FALSE	FALSE
GALNT12	FALSE	FALSE
GAS7	FALSE	FALSE
GATA1	FALSE	FALSE
GATA2	FALSE	TRUE
GATA3	TRUE	FALSE
GATA4	FALSE	FALSE
GATA6	FALSE	FALSE
GBA	FALSE	FALSE
GEN1	FALSE	FALSE
GID4	FALSE	FALSE
GJB2	FALSE	FALSE
GKN1	TRUE	TRUE
GLI1	FALSE	TRUE
GMPS	FALSE	FALSE
GNA11	FALSE	TRUE
GNA12	FALSE	FALSE
GNA13	FALSE	FALSE
GNAQ	FALSE	TRUE
GNAS	FALSE	TRUE
GNB1	FALSE	FALSE
GNMT	TRUE	FALSE
GOLGA5	FALSE	FALSE
GOPC	FALSE	FALSE
GPC3	FALSE	FALSE
GPC5	TRUE	FALSE
GPHN	FALSE	FALSE
GPRC5A	TRUE	FALSE
GPS2	FALSE	FALSE
GREM1	FALSE	FALSE
GRIN2A	TRUE	FALSE
GRM3	FALSE	TRUE
GSK3B	FALSE	FALSE
GSTP1	TRUE	FALSE
GTF2I	FALSE	FALSE
H3F3A	FALSE	TRUE
H3F3B	FALSE	TRUE
H3F3C	FALSE	FALSE
HABP2	FALSE	FALSE
HDAC1	FALSE	FALSE
HDAC4	FALSE	FALSE
HDAC7	FALSE	FALSE
HERPUD1	FALSE	FALSE
HEY1	FALSE	TRUE
HFE	FALSE	FALSE
HGF	FALSE	TRUE
HIF1A	FALSE	TRUE
HIP1	FALSE	TRUE
HIST1H1B	FALSE	FALSE
HIST1H1C	FALSE	FALSE
HIST1H1D	FALSE	FALSE
HIST1H1E	FALSE	FALSE
HIST1H2AC	FALSE	FALSE
HIST1H2AG	FALSE	FALSE
HIST1H2AL	FALSE	FALSE
HIST1H2AM	FALSE	FALSE
HIST1H2BC	FALSE	FALSE
HIST1H2BD	FALSE	FALSE
HIST1H2BG	FALSE	FALSE
HIST1H2BJ	FALSE	FALSE
HIST1H2BK	FALSE	FALSE
HIST1H2BO	FALSE	FALSE
HIST1H3A	FALSE	FALSE
HIST1H3B	FALSE	TRUE
HIST1H3C	FALSE	FALSE
HIST1H3D	FALSE	FALSE
HIST1H3E	FALSE	FALSE
HIST1H3F	FALSE	FALSE
HIST1H3G	FALSE	FALSE
HIST1H3H	FALSE	FALSE
HIST1H3I	FALSE	FALSE
HIST1H3J	FALSE	FALSE
HIST1H4I	FALSE	FALSE
HIST2H3A	FALSE	FALSE
HIST2H3C	FALSE	FALSE
HIST2H3D	FALSE	FALSE
HIST3H3	FALSE	FALSE
HLA-A	FALSE	FALSE
HLA-B	FALSE	FALSE
HLA-C	FALSE	FALSE
HLF	FALSE	TRUE
HMBS	FALSE	FALSE
HMGA1	FALSE	TRUE
HMGA2	FALSE	TRUE
HNF1A	TRUE	FALSE
HNF1B	FALSE	FALSE
HNRNPA2B1	FALSE	TRUE
HOOK3	FALSE	FALSE
HOXA11	FALSE	FALSE
HOXA13	FALSE	TRUE
HOXA9	FALSE	TRUE
HOXB13	FALSE	FALSE
HOXC11	FALSE	TRUE
HOXC13	FALSE	TRUE
HOXD11	FALSE	TRUE
HOXD13	FALSE	TRUE
HPGD	TRUE	FALSE
HRAS	FALSE	TRUE
HSD3B1	FALSE	FALSE
HSP90AA1	FALSE	FALSE
HSP90AB1	FALSE	FALSE
ICOSLG	FALSE	FALSE
ID3	TRUE	FALSE
ID4	TRUE	TRUE
IDH1	FALSE	TRUE
IDH2	FALSE	TRUE
IFNGR1	FALSE	FALSE
IGF1	FALSE	FALSE
IGF1R	FALSE	FALSE
IGF2	FALSE	FALSE
IGF2BP2	TRUE	FALSE
IGFBP2	FALSE	TRUE
IGFBP7	TRUE	FALSE
IGH	FALSE	FALSE
IGK	FALSE	FALSE
IGL	FALSE	FALSE
IKBKB	FALSE	TRUE
IKBKE	FALSE	FALSE
IKZF1	TRUE	TRUE
IKZF3	FALSE	FALSE
IL10	FALSE	FALSE
IL2	FALSE	FALSE
IL21R	FALSE	FALSE
IL2RA	FALSE	FALSE
IL6	FALSE	TRUE
IL6R	FALSE	FALSE
IL6ST	FALSE	TRUE
IL7R	FALSE	TRUE
INHA	FALSE	FALSE
INHBA	FALSE	FALSE
INPP4A	FALSE	FALSE
INPP4B	TRUE	TRUE
INPPL1	FALSE	FALSE
INSR	FALSE	FALSE
IRF1	FALSE	FALSE
IRF2	FALSE	FALSE
IRF4	FALSE	TRUE
IRF8	FALSE	FALSE
IRS1	FALSE	FALSE
IRS2	FALSE	FALSE
IRS4	FALSE	FALSE
ISX	FALSE	FALSE
ITGAV	FALSE	FALSE
ITK	FALSE	FALSE
JAK1	FALSE	FALSE
JAK2	FALSE	TRUE
JAK3	FALSE	TRUE
JARID2	FALSE	FALSE
JAZF1	FALSE	FALSE
JMJD1C	FALSE	FALSE
JUN	FALSE	TRUE
KAT6A	FALSE	TRUE
KAT6B	TRUE	FALSE
KAT7	FALSE	TRUE
KCNJ5	FALSE	TRUE
KDM5A	FALSE	TRUE
KDM5C	TRUE	FALSE
KDM6A	FALSE	FALSE
KDR	FALSE	TRUE
KDSR	FALSE	FALSE
KEAP1	TRUE	FALSE
KEL	FALSE	FALSE
KIAA1549	FALSE	FALSE
KIAA1598	FALSE	FALSE
KIF14	FALSE	TRUE
KIF1B	FALSE	FALSE
KIF5B	FALSE	FALSE
KISS1	TRUE	FALSE
KIT	FALSE	TRUE
KL	TRUE	FALSE
KLF4	TRUE	TRUE
KLF5	TRUE	TRUE
KLF6	TRUE	FALSE
KLHL6	FALSE	FALSE
KLK2	FALSE	FALSE
KLLN	FALSE	FALSE
KMT2A	FALSE	TRUE
KMT2B	FALSE	FALSE
KMT2C	TRUE	FALSE
KMT2D	FALSE	FALSE
KMT5A	FALSE	FALSE
KNL1	TRUE	FALSE
KNSTRN	FALSE	TRUE
KRAS	TRUE	TRUE
KSR2	FALSE	FALSE
KTN1	FALSE	FALSE
LAMP1	FALSE	FALSE
LARP4B	TRUE	FALSE
LASP1	FALSE	FALSE
LATS1	TRUE	FALSE
LATS2	TRUE	FALSE
LCK	FALSE	TRUE
LCP1	FALSE	FALSE
LEF1	FALSE	FALSE
LEPROTL1	TRUE	FALSE
LHFP	FALSE	FALSE
LHFPL6	FALSE	FALSE
LIFR	FALSE	FALSE
LIN28B	FALSE	TRUE
LMNA	FALSE	FALSE
LMO1	FALSE	TRUE
LMO2	FALSE	TRUE
LOX	TRUE	TRUE
LPP	FALSE	TRUE
LRIG3	TRUE	FALSE
LRP1B	TRUE	FALSE
LRRC4	TRUE	FALSE
LRRK2	FALSE	FALSE
LSM14A	FALSE	FALSE
LTB	FALSE	FALSE
LYL1	FALSE	TRUE
LYN	FALSE	FALSE
LZTR1	TRUE	FALSE
MACC1	FALSE	TRUE
MAF	FALSE	TRUE
MAFB	FALSE	TRUE
MAGI2	FALSE	FALSE
MALAT1	FALSE	FALSE
MALT1	FALSE	TRUE
MAML2	FALSE	TRUE
MAP2K1	FALSE	TRUE
MAP2K2	FALSE	TRUE
MAP2K4	FALSE	FALSE
MAP3K1	FALSE	FALSE
MAP3K13	FALSE	FALSE
MAP3K14	FALSE	FALSE
MAP3K6	FALSE	FALSE
MAP3K7	FALSE	FALSE
MAPK1	FALSE	TRUE
MAPK3	FALSE	FALSE
MAPKAP1	FALSE	FALSE
MARK2	FALSE	TRUE
MAX	TRUE	FALSE
MB21D2	FALSE	FALSE
MCC	TRUE	FALSE
MCL1	FALSE	FALSE
MDC1	FALSE	FALSE
MDM2	FALSE	TRUE
MDM4	FALSE	TRUE
MDS2	FALSE	FALSE
MECOM	FALSE	TRUE
MED12	TRUE	FALSE
MEF2B	FALSE	FALSE
MEIS1	FALSE	TRUE
MEN1	TRUE	TRUE
MET	FALSE	TRUE
MGA	FALSE	FALSE
MGAM	FALSE	FALSE
MGMT	TRUE	FALSE
MIB1	FALSE	FALSE
MITF	FALSE	TRUE
MKI67	FALSE	FALSE
MKL1	FALSE	FALSE
MLF1	TRUE	FALSE
MLH1	TRUE	FALSE
MLH3	FALSE	FALSE
MLLT1	FALSE	FALSE
MLLT10	FALSE	TRUE
MLLT11	FALSE	TRUE
MLLT3	FALSE	TRUE
MLLT4	FALSE	FALSE
MLLT6	FALSE	FALSE
MN1	FALSE	TRUE
MNX1	FALSE	TRUE
MOB3B	FALSE	FALSE
MPEG1	FALSE	FALSE
MPL	FALSE	TRUE
MRE11	FALSE	FALSE
MRE11A	FALSE	FALSE
MS4A1	FALSE	FALSE
MSH2	TRUE	FALSE
MSH3	FALSE	FALSE
MSH6	TRUE	FALSE
MSI1	FALSE	FALSE
MSI2	FALSE	TRUE
MSN	FALSE	FALSE
MST1	FALSE	FALSE
MST1R	FALSE	TRUE
MTAP	FALSE	FALSE
MTCP1	FALSE	TRUE
MTDH	FALSE	TRUE
MTOR	FALSE	TRUE
MTSS1	TRUE	FALSE
MUC1	FALSE	TRUE
MUC16	FALSE	TRUE
MUC4	FALSE	TRUE
MUTYH	TRUE	FALSE
MYB	FALSE	TRUE
MYC	FALSE	TRUE
MYCL	FALSE	TRUE
MYCN	TRUE	TRUE
MYD88	FALSE	TRUE
MYH11	FALSE	FALSE
MYH9	TRUE	FALSE
MYO18B	TRUE	FALSE
MYO5A	FALSE	FALSE
MYOD1	FALSE	TRUE
N4BP2	TRUE	FALSE
NAB2	TRUE	FALSE
NACA	FALSE	FALSE
NAV3	FALSE	FALSE
NBEA	FALSE	FALSE
NBN	TRUE	FALSE
NCKIPSD	FALSE	FALSE
NCOA1	FALSE	FALSE
NCOA2	FALSE	TRUE
NCOA3	FALSE	TRUE
NCOA4	TRUE	FALSE
NCOR1	TRUE	FALSE
NCOR2	TRUE	FALSE
NCSTN	FALSE	FALSE
NDRG1	TRUE	FALSE
NDRG2	TRUE	FALSE
NEGR1	FALSE	FALSE
NEK1	FALSE	FALSE
NF1	TRUE	FALSE
NF2	TRUE	FALSE
NFATC2	FALSE	TRUE
NFE2	FALSE	FALSE
NFE2L2	FALSE	FALSE
NFE2L3	FALSE	FALSE
NFIB	FALSE	TRUE
NFKB1	FALSE	TRUE
NFKB2	FALSE	FALSE
NFKBIA	FALSE	FALSE
NFKBIE	TRUE	FALSE
NHP2	FALSE	FALSE
NIN	FALSE	FALSE
NKX2-1	FALSE	TRUE
NKX3-1	FALSE	FALSE
NONO	FALSE	FALSE
NOP10	FALSE	FALSE
NOTCH1	TRUE	TRUE
NOTCH2	TRUE	TRUE
NOTCH3	FALSE	FALSE
NOTCH4	FALSE	FALSE
NPM1	FALSE	TRUE
NR0B2	TRUE	FALSE
NR4A3	TRUE	TRUE
NRAS	FALSE	TRUE
NRG1	TRUE	FALSE
NSD1	FALSE	FALSE
NSD2	FALSE	TRUE
NSD3	FALSE	TRUE
NT5C2	FALSE	TRUE
NTHL1	TRUE	FALSE
NTRK1	FALSE	TRUE
NTRK2	FALSE	FALSE
NTRK3	FALSE	TRUE
NUF2	FALSE	FALSE
NUMA1	FALSE	FALSE
NUP214	FALSE	FALSE
NUP93	FALSE	FALSE
NUP98	FALSE	TRUE
NUTM1	FALSE	TRUE
NUTM2A	FALSE	FALSE
NUTM2B	FALSE	FALSE
OGG1	FALSE	FALSE
OLIG2	FALSE	TRUE
OMD	FALSE	FALSE
OTX2	FALSE	TRUE
P2RY8	FALSE	TRUE
PABPC1	FALSE	FALSE
PAFAH1B2	FALSE	FALSE
PAK1	FALSE	FALSE
PAK3	FALSE	FALSE
PAK5	FALSE	FALSE
PAK7	FALSE	FALSE
PALB2	TRUE	FALSE
PARK2	FALSE	FALSE
PARK7	FALSE	TRUE
PARP1	FALSE	FALSE
PATZ1	TRUE	FALSE
PAWR	TRUE	TRUE
PAX3	FALSE	TRUE
PAX5	TRUE	TRUE
PAX6	TRUE	FALSE
PAX7	FALSE	FALSE
PAX8	FALSE	FALSE
PBRM1	TRUE	FALSE
PBX1	FALSE	TRUE
PCBP1	FALSE	FALSE
PCLO	FALSE	FALSE
PCM1	FALSE	FALSE
PDCD1	FALSE	FALSE
PDCD1LG2	FALSE	TRUE
PDCD4	TRUE	TRUE
PDE4DIP	FALSE	FALSE
PDGFB	FALSE	TRUE
PDGFRA	FALSE	TRUE
PDGFRB	FALSE	TRUE
PDK1	FALSE	FALSE
PDLIM7	FALSE	TRUE
PDPK1	FALSE	FALSE
PDS5B	FALSE	FALSE
PDX1	TRUE	TRUE
PER1	TRUE	FALSE
PGR	FALSE	FALSE
PHF1	FALSE	FALSE
PHF6	TRUE	FALSE
PHOX2B	TRUE	FALSE
PI3	FALSE	TRUE
PICALM	FALSE	FALSE
PIGA	FALSE	FALSE
PIK3C2B	FALSE	FALSE
PIK3C2G	FALSE	FALSE
PIK3C3	FALSE	FALSE
PIK3CA	FALSE	TRUE
PIK3CB	FALSE	TRUE
PIK3CD	FALSE	FALSE
PIK3CG	FALSE	FALSE
PIK3R1	TRUE	FALSE
PIK3R2	FALSE	FALSE
PIK3R3	FALSE	FALSE
PIM1	FALSE	TRUE
PINK1	FALSE	FALSE
PLAG1	FALSE	TRUE
PLAGL2	FALSE	TRUE
PLCG1	FALSE	TRUE
PLCG2	FALSE	FALSE
PLK2	FALSE	FALSE
PLXNB1	TRUE	TRUE
PMAIP1	FALSE	FALSE
PML	TRUE	TRUE
PMS1	FALSE	FALSE
PMS2	TRUE	FALSE
PNRC1	FALSE	FALSE
POLD1	TRUE	FALSE
POLE	TRUE	FALSE
POLG	TRUE	FALSE
POLH	FALSE	FALSE
POLQ	FALSE	FALSE
POT1	TRUE	FALSE
POU2AF1	FALSE	TRUE
POU2F2	FALSE	FALSE
POU3F2	FALSE	TRUE
POU5F1	FALSE	TRUE
PPARG	TRUE	FALSE
PPFIBP1	FALSE	FALSE
PPM1D	FALSE	TRUE
PPP2R1A	TRUE	FALSE
PPP2R2A	FALSE	FALSE
PPP4R2	FALSE	FALSE
PPP6C	TRUE	FALSE
PRCC	FALSE	FALSE
PRDM1	TRUE	FALSE
PRDM14	FALSE	FALSE
PRDM16	FALSE	TRUE
PRDM2	TRUE	FALSE
PRDM9	FALSE	FALSE
PREX2	FALSE	TRUE
PRF1	TRUE	FALSE
PRKACA	FALSE	TRUE
PRKAR1A	FALSE	FALSE
PRKCB	FALSE	FALSE
PRKCI	FALSE	FALSE
PRKD1	FALSE	FALSE
PRKDC	FALSE	FALSE
PRKN	FALSE	FALSE
PRPF40B	FALSE	FALSE
PRR11	FALSE	TRUE
PRRX1	FALSE	FALSE
PRSS1	FALSE	FALSE
PRSS8	FALSE	FALSE
PSIP1	FALSE	TRUE
PTCH1	TRUE	TRUE
PTEN	TRUE	TRUE
PTGDR	FALSE	TRUE
PTGS2	FALSE	TRUE
PTK6	FALSE	FALSE
PTP4A1	FALSE	FALSE
PTPN1	FALSE	FALSE
PTPN11	TRUE	TRUE
PTPN13	TRUE	FALSE
PTPN2	FALSE	FALSE
PTPN6	TRUE	FALSE
PTPRB	TRUE	FALSE
PTPRC	TRUE	FALSE
PTPRD	TRUE	FALSE
PTPRK	TRUE	FALSE
PTPRO	TRUE	FALSE
PTPRS	FALSE	FALSE
PTPRT	TRUE	FALSE
PTTG1	FALSE	TRUE
PWWP2A	FALSE	FALSE
QKI	TRUE	FALSE
RAB25	TRUE	TRUE
RAB35	FALSE	FALSE
RABEP1	FALSE	FALSE
RAC1	FALSE	TRUE
RAC2	FALSE	FALSE
RAD17	TRUE	FALSE
RAD21	FALSE	FALSE
RAD50	FALSE	FALSE
RAD51	FALSE	FALSE
RAD51B	TRUE	FALSE
RAD51C	FALSE	FALSE
RAD51D	FALSE	FALSE
RAD52	FALSE	FALSE
RAD54L	FALSE	FALSE
RAF1	FALSE	TRUE
RALGDS	FALSE	FALSE
RANBP2	TRUE	FALSE
RAP1GAP	TRUE	FALSE
RAP1GDS1	FALSE	TRUE
RARA	FALSE	TRUE
RARRES1	TRUE	FALSE
RASA1	FALSE	FALSE
RASAL1	TRUE	FALSE
RASSF1	TRUE	FALSE
RB1	TRUE	FALSE
RBM10	TRUE	FALSE
RBM15	FALSE	FALSE
RCC2	FALSE	FALSE
RECQL	FALSE	FALSE
RECQL4	FALSE	FALSE
REL	FALSE	TRUE
RELB	FALSE	TRUE
RELN	FALSE	FALSE
RET	TRUE	TRUE
RFWD2	FALSE	FALSE
RFWD3	TRUE	FALSE
RGPD3	FALSE	FALSE
RGS7	FALSE	FALSE
RHBDF2	FALSE	FALSE
RHEB	FALSE	FALSE
RHNO1	FALSE	FALSE
RHOA	FALSE	FALSE
RHOH	TRUE	FALSE
RICTOR	FALSE	FALSE
RING1	FALSE	FALSE
RINT1	FALSE	FALSE
RIT1	FALSE	FALSE
RMI2	TRUE	FALSE
RMRP	FALSE	FALSE
RNF213	FALSE	FALSE
RNF43	TRUE	FALSE
ROBO1	FALSE	FALSE
ROBO2	TRUE	FALSE
ROS1	FALSE	TRUE
RPL10	TRUE	FALSE
RPL22	TRUE	FALSE
RPL5	TRUE	FALSE
RPN1	FALSE	FALSE
RPS15	FALSE	FALSE
RPS6KA4	FALSE	FALSE
RPS6KB1	FALSE	FALSE
RPS6KB2	FALSE	FALSE
RPTOR	FALSE	FALSE
RRAGC	FALSE	FALSE
RRAS	FALSE	FALSE
RRAS2	FALSE	FALSE
RSPO2	TRUE	FALSE
RSPO3	FALSE	TRUE
RTEL1	FALSE	FALSE
RUNX1	TRUE	TRUE
RUNX1T1	FALSE	FALSE
RUNX3	TRUE	TRUE
RXRA	FALSE	FALSE
RYBP	FALSE	FALSE
S100A7	FALSE	FALSE
SALL4	FALSE	TRUE
SAMHD1	FALSE	FALSE
SASH1	TRUE	FALSE
SBDS	TRUE	FALSE
SCG5	FALSE	FALSE
SDC4	FALSE	FALSE
SDHA	TRUE	FALSE
SDHAF2	TRUE	FALSE
SDHB	TRUE	FALSE
SDHC	TRUE	FALSE
SDHD	TRUE	FALSE
SEC31A	FALSE	FALSE
SEMA3B	TRUE	FALSE
SEPT5	FALSE	FALSE
SEPT6	FALSE	FALSE
SEPT9	FALSE	FALSE
SERPINA1	FALSE	FALSE
SERPINB5	TRUE	FALSE
SESN1	FALSE	FALSE
SESN2	FALSE	FALSE
SESN3	FALSE	FALSE
SET	FALSE	TRUE
SETBP1	FALSE	TRUE
SETD1A	FALSE	FALSE
SETD1B	TRUE	FALSE
SETD2	TRUE	FALSE
SETD3	FALSE	FALSE
SETD4	FALSE	FALSE
SETD5	FALSE	FALSE
SETD6	FALSE	FALSE
SETD7	FALSE	FALSE
SETDB1	FALSE	TRUE
SETDB2	FALSE	FALSE
SF3B1	FALSE	TRUE
SFPQ	TRUE	FALSE
SFRP1	TRUE	FALSE
SFRP4	TRUE	FALSE
SGK1	FALSE	TRUE
SH2B3	TRUE	FALSE
SH2D1A	FALSE	FALSE
SH3GL1	FALSE	TRUE
SHH	FALSE	TRUE
SHOC2	FALSE	FALSE
SHQ1	FALSE	FALSE
SHTN1	FALSE	FALSE
SIN3A	FALSE	FALSE
SIRPA	TRUE	FALSE
SIRT1	TRUE	TRUE
SIRT2	TRUE	TRUE
SIRT3	TRUE	FALSE
SIRT6	FALSE	TRUE
SIX1	FALSE	TRUE
SIX2	FALSE	TRUE
SKI	FALSE	TRUE
SKP2	FALSE	TRUE
SLC25A13	FALSE	FALSE
SLC34A2	TRUE	FALSE
SLC45A3	FALSE	FALSE
SLIT2	FALSE	FALSE
SLX4	FALSE	FALSE
SMAD2	TRUE	FALSE
SMAD3	TRUE	FALSE
SMAD4	TRUE	TRUE
SMARCA1	FALSE	FALSE
SMARCA4	TRUE	FALSE
SMARCB1	TRUE	TRUE
SMARCD1	TRUE	FALSE
SMARCE1	TRUE	FALSE
SMC1A	TRUE	FALSE
SMC3	FALSE	FALSE
SMG1	FALSE	FALSE
SMO	FALSE	TRUE
SMURF1	FALSE	TRUE
SMYD3	FALSE	FALSE
SNCAIP	FALSE	FALSE
SND1	FALSE	TRUE
SNX29	FALSE	FALSE
SOCS1	TRUE	TRUE
SOS1	FALSE	FALSE
SOX1	TRUE	FALSE
SOX10	FALSE	FALSE
SOX17	FALSE	FALSE
SOX2	FALSE	TRUE
SOX21	TRUE	FALSE
SOX4	FALSE	TRUE
SOX9	TRUE	TRUE
SP140	FALSE	FALSE
SPARC	TRUE	FALSE
SPDEF	TRUE	TRUE
SPECC1	FALSE	FALSE
SPEN	TRUE	FALSE
SPI1	TRUE	TRUE
SPINK1	FALSE	FALSE
SPOP	TRUE	FALSE
SPRED1	FALSE	FALSE
SPRTN	FALSE	FALSE
SPTA1	FALSE	FALSE
SRC	FALSE	TRUE
SRF	FALSE	TRUE
SRGAP3	FALSE	FALSE
SRSF2	FALSE	TRUE
SRSF3	FALSE	TRUE
SRY	FALSE	FALSE
SS18	FALSE	FALSE
SS18L1	FALSE	FALSE
SSX1	FALSE	TRUE
SSX2	FALSE	TRUE
SSX4	FALSE	TRUE
STAG1	TRUE	FALSE
STAG2	TRUE	FALSE
STAT1	TRUE	FALSE
STAT3	TRUE	TRUE
STAT4	FALSE	FALSE
STAT5A	FALSE	FALSE
STAT5B	FALSE	FALSE
STAT6	FALSE	TRUE
STIL	FALSE	TRUE
STK11	TRUE	FALSE
STK19	FALSE	FALSE
STK40	FALSE	FALSE
STRN	FALSE	FALSE
SUFU	TRUE	FALSE
SUZ12	FALSE	FALSE
SYK	TRUE	TRUE
TACC1	FALSE	FALSE
TAF1	FALSE	FALSE
TAF15	FALSE	TRUE
TAL1	FALSE	TRUE
TAL2	FALSE	TRUE
TAP1	FALSE	FALSE
TAP2	FALSE	FALSE
TAZ	FALSE	TRUE
TBL1XR1	FALSE	FALSE
TBX3	FALSE	FALSE
TCEA1	FALSE	FALSE
TCEB1	FALSE	FALSE
TCF12	FALSE	FALSE
TCF3	TRUE	TRUE
TCF7L2	FALSE	TRUE
TCL1A	FALSE	TRUE
TEC	FALSE	TRUE
TEK	FALSE	FALSE
TENT5C	FALSE	FALSE
TERC	FALSE	FALSE
TERF2IP	FALSE	FALSE
TERT	FALSE	TRUE
TET1	TRUE	TRUE
TET2	TRUE	FALSE
TET3	FALSE	FALSE
TFCP2	FALSE	TRUE
TFE3	FALSE	TRUE
TFEB	FALSE	TRUE
TFF1	TRUE	TRUE
TFG	FALSE	FALSE
TFPT	FALSE	FALSE
TFRC	FALSE	FALSE
TGFBR1	FALSE	FALSE
TGFBR2	TRUE	FALSE
THRAP3	FALSE	FALSE
THY1	TRUE	FALSE
TLR4	FALSE	FALSE
TLX1	FALSE	TRUE
TLX3	FALSE	TRUE
TMEM127	TRUE	FALSE
TMPRSS2	FALSE	FALSE
TNC	FALSE	TRUE
TNFAIP3	TRUE	FALSE
TNFRSF14	TRUE	FALSE
TNFRSF17	FALSE	TRUE
TNFRSF6	FALSE	FALSE
TOP1	FALSE	FALSE
TOP2A	FALSE	FALSE
TP53	TRUE	TRUE
TP53BP1	FALSE	FALSE
TP63	FALSE	TRUE
TPD52	FALSE	TRUE
TPM3	TRUE	FALSE
TPM4	FALSE	FALSE
TPMT	FALSE	FALSE
TPR	FALSE	FALSE
TRA	FALSE	FALSE
TRAF2	FALSE	FALSE
TRAF3	FALSE	FALSE
TRAF5	FALSE	FALSE
TRAF7	TRUE	FALSE
TRB	FALSE	FALSE
TRD	FALSE	FALSE
TRIM24	FALSE	TRUE
TRIM27	FALSE	TRUE
TRIM3	TRUE	FALSE
TRIM33	TRUE	FALSE
TRIM37	FALSE	FALSE
TRIP11	FALSE	FALSE
TRRAP	FALSE	TRUE
TSC1	TRUE	FALSE
TSC2	TRUE	FALSE
TSHR	FALSE	TRUE
TTF1	FALSE	TRUE
TUSC3	TRUE	TRUE
TWIST1	FALSE	TRUE
TWSG1	TRUE	FALSE
TYK2	FALSE	FALSE
TYMS	FALSE	FALSE
U2AF1	FALSE	TRUE
U2AF2	FALSE	FALSE
UBR5	TRUE	FALSE
UCHL1	TRUE	TRUE
UGT1A1	FALSE	FALSE
UHRF1	FALSE	TRUE
UPF1	FALSE	FALSE
UROD	FALSE	FALSE
USP44	TRUE	FALSE
USP6	FALSE	TRUE
USP8	FALSE	TRUE
USP9X	TRUE	FALSE
VAV1	FALSE	FALSE
VAV2	FALSE	FALSE
VEGFA	FALSE	TRUE
VHL	TRUE	TRUE
VTCN1	FALSE	FALSE
VTI1A	FALSE	FALSE
WAS	FALSE	TRUE
WDCP	FALSE	FALSE
WEE1	FALSE	FALSE
WHSC1	FALSE	FALSE
WHSC1L1	FALSE	FALSE
WIF1	TRUE	FALSE
WISP1	TRUE	TRUE
WISP3	FALSE	FALSE
WNK2	TRUE	FALSE
WNT1	FALSE	TRUE
WNT5A	TRUE	FALSE
WRN	TRUE	FALSE
WT1	TRUE	TRUE
WWOX	TRUE	FALSE
WWTR1	FALSE	TRUE
XBP1	FALSE	FALSE
XIAP	FALSE	FALSE
XPA	TRUE	FALSE
XPC	TRUE	FALSE
XPO1	FALSE	TRUE
XRCC2	FALSE	FALSE
YAP1	TRUE	TRUE
YES1	FALSE	FALSE
YWHAE	TRUE	FALSE
ZBTB16	TRUE	TRUE
ZBTB2	FALSE	FALSE
ZBTB7A	FALSE	TRUE
ZCCHC8	FALSE	FALSE
ZEB1	TRUE	TRUE
ZFHX3	TRUE	FALSE
ZMYM2	FALSE	FALSE
ZMYM3	TRUE	FALSE
ZNF198	FALSE	FALSE
ZNF217	FALSE	FALSE
ZNF278	FALSE	FALSE
ZNF331	TRUE	FALSE
ZNF384	FALSE	FALSE
ZNF429	FALSE	FALSE
ZNF479	FALSE	FALSE
ZNF521	FALSE	TRUE
ZNF703	FALSE	TRUE
ZNF750	FALSE	FALSE
ZNRF3	TRUE	FALSE
ZRSR2	TRUE	FALSE
